11 4 4 4 4 4 4 4 4 4 4 4 4 4 4 4 4 5
6 0 0 0 0 0 0 0 0 0 0 0 0 0 0 0 0 7
6 0 0 0 0 0 0 0 0 0 0 0 0 0 0 0 0 7
6 0 0 0 0 0 1 2 1 0 0 0 0 0 0 0 0 7
6 0 0 0 0 0 0 1 3 2 0 0 0 0 0 0 0 7
6 0 0 0 0 0 0 0 0 0 0 0 0 0 0 0 0 7
6 0 0 0 0 0 0 0 0 0 0 0 0 0 0 0 0 7
6 0 0 0 0 0 0 0 0 0 0 0 0 0 0 0 0 7
6 0 0 2 1 0 0 0 0 0 0 0 0 0 0 0 0 7
6 0 0 3 2 1 0 0 0 0 0 0 0 0 0 0 0 7
6 0 0 0 0 0 0 0 0 0 0 0 0 0 0 0 0 7
8 9 9 9 9 9 9 9 9 9 9 9 9 9 9 9 9 10